[SOLID_CELL:W,P,-]
[FREE_CELL_FLOOR: ]
[CELL_RENDER(W):F,50,50,50]
[CELL_RENDER(P):R,100,100,100]
[CELL_RENDER(-):F,0,0,0]
[CELL_RENDER( ):F,0,0,0]

[SPAWN_ENABLED:true]

<---------------------------------------->
<---------------------------------------->
<---------------------------------------->
<---------------------------------------->
<---------------------------------------->
<---------------------------------------->
<---------------------------------------->
<---------------------------------------->
<---------------------------------------->
<---------------------------------------->
<---------------------------------------->
<---------------------------------------->
<---------------------------------------->
<---------------------------------------->
<---------------------------------------->
<---------------------------------------->
<---------------------------------------->
<---------------------------------------->
<---------------------------------------->
<---------------------------------------->
<---------------------------------------->
<---------------------------------------->
<---------------------------------------->
<---------------------------------------->
<---PPPP--------------------------PPPP--->
<---PWWPWWPPWWPPWWPPWWPPWWPPWWPPWWPWWPWWP>
<---PWWPWWPPWWPPWWPPWWPPWWPPWWPPWWPWWPWWP>
<---PPPP                          PPPP   >
<----WW                                  >
<----WW                                  >
<----PP                                  >
<----PP                                  >
<----WW                                  >
<----WW                                  >
<----PP                                  >
<----PP                                  >
<----WW                                  >
<----WW      PPPP        PPPP            >
<PPWWPPWWPPWWPWWP        PWWPWWPPWWPPWWPP>
<PPWWPPWWPPWWPWWP        PWWPWWPPWWPPWWPP>
$