SPAWN_ENABLED=[true]

<WWWWWWWWWWWWWWWW        WWWWWWWWWWWWWWWW>
<WWWWWWWWWWWWWWWW        WWWWWWWWWWWWWWWW>
<WW                                    WW>
<WW                                    WW>
<WW                                    WW>
<WW                                    WW>
<WW                                    WW>
<WW                                    WW>
<WW                                    WW>
<WW                                    WW>
<WW                                    WW>
<WW                                    WW>
<WW                                    WW>
<WW                                    WW>
<WW                                    WW>
<WW                                    WW>
<                                        >
<                                        >
<                                        >
<                                        >
<                                        >
<                                        >
<                                        >
<                                        >
<WW                                    WW>
<WW                                    WW>
<WW                                    WW>
<WW                                    WW>
<WW                                    WW>
<WW                                    WW>
<WW                                    WW>
<WW                                    WW>
<WW                                    WW>
<WW                                    WW>
<WW                                    WW>
<WW                                    WW>
<WW                                    WW>
<WW                                    WW>
<WWWWWWWWWWWWWWWW        WWWWWWWWWWWWWWWW>
<WWWWWWWWWWWWWWWW        WWWWWWWWWWWWWWWW>
$